----****
-****--**
-*-b----*
-*-b-*g-*
**-***g**
*-------*
*---*--y*
*********
