-
---------****-
------****--**
------*-b----*
------*-b-*--*
-----**-***-**
-----*-------*
-----*---*---*
-----*********