----****-
-****--**
-*-b----*
-*-b-*g-*
**-***g**
*-------*
*---*---*
*********